00000000000000000000
01111111101111111110
01133331101111111110
01111221101222222210
01133331101111111110
01111111100111111110
00000000000000000000
01111001100000000000
01110011122244441110
01100111111144422110
01003333111114411110
00011333111144421110
00000000000000000000
