00000000000000000000
01111111101111111110
01133331101111111110
01111221101222222210
01133331101111111110
01111111100111111110
00000000000000000000
01111001100111111110
01110011122222221110
01100111111122222110
01003333111111111110
00011333111112221110
00000000000000000000
