00000000000000000000
01111111101111511110
01133331101111511110
01111221101222522210
01133331101111511110
01111111100111511110
00000000000000000000
01111001100000000000
01610011122244441110
01100111111144422110
01003331111114411110
00011333111144421110
00000000000000000000
