00000000000000000000
01111111111111111110
01133331111111111110
01111221111222222210
01133331111111111110
01111111100111111110
00000000000000000000
01111111100111111110
01111111122222221110
01111111111122222110
01113333111111111110
01111333111112221110
00000000000000000000
