00000000000000000000
10000000000100000000
10001110000100000000
10001110000100000000
10001110000100000000
10000000000111101111
10000000000000000001
11111111110000000001
11111111110000000001
11111111110000000001
11111111110000000001
11111111110000000001
11111111110000000000
