00000000000000000000
00000200000100002000
00001110000100000000
00001110000100000000
00001110000100000000
00000000000111101110
00000000000000000000
01111111110000333000
01111111110000000000
01111111110000000000
01111111110000200000
01111111110000000000
00000000000000000000
