00000000000000000000
00111111100000001100
00000011100000000100
00003300100000000000
00002220100000000000
00000000000000000000
00000000000000000000
00000222030000000000
00011111000000003300
00011133300000033300
00001112210000003330
00000000000000000000
00000000000000000000
