00000000000000000000
00000000444444000000
00006000044444444000
00002220100000000000
00000000000000000100
00000000000000011100
00000222030000000000
00000000000000000000
00333033300000000000
00355555300000000000
00355555300000000000
00333333300000000000
00000000000000000060
