00000000000000000000
00004400005555000000
00004040050000554200
00004055555554505200
00004450544454455500
00004455445562205400
00000554544640030400
00044444514450330500
00445444414455350500
00044444415005304500
00004440505553345500
00000000000050005000
00000000000000000000
