00000000000000000000
00004440000110000000
00044444400100000000
00444444440105555000
00044444440155550000
00004044401055550000
00000000011005500000
00111111111000022200
00003001110000220000
00003301110222200000
00000000011110001110
00000000000011111000
00000000000000000000
