00000000000000000000
00000000000000000000
00000033333333300000
00055000000000000000
00055500555505055000
00050500500055555555
00050050555550505505
00050550500050005555
00055500555500605050
00003000000000000000
00003333333000220000
00000000000000000000
00000000000000000000
